----------------------------------------------------------------------------------------------------
----------------------------------------------------------------------------------------------------
---------------------------------------------------------------------------------------------X------
----------------------------------------------------------------------------------------------------
------------xxxxxxxxxxx--------------E--------------------------------------------------------------
---SSSS----xx--QQQ?QQQ-x-------SSSSS-----------------------------XX-----------------------------XXXX
----------xx------------x----------------------------------------XX---------------------------------
---------xx------E-------x-----------------------------------xxx-XX------------------------------xxx
-------xxx-----SSSSSSS----x---------------------------------xxXx-XX--------------------------xxxxx--
------xx<>--------------E--x----EXXX-----------------------xxXX--XX-------------------------xxXXXXEX
-----xx-[]-------X------X---x-------------------------E--ExxXXX-xXX------------------------xx-------
----xx--[]-------X------X----x-------------------B-------xxXXXX--x--------xxx--------xxxxxxx--------
xxxxx---[]----E--X------X-----xxxxxxxxxxxxxxxxxxxxxxxxxxxxXXXXX---xxxxxxxxxX-xxxxxxxxx--XXXX--------
XXXXXXXXXXXXXXXXXXXXXXXXXXXXXXXXXXXXXXXXXXXXXXXXXXXXXXXXXXXXXXXXXXXXXXXXXXXXXXXXXXXXXX--------------